<?xml version="1.0" encoding="UTF-8"?>
<Preferences>
<Pref ID="WindowLayout" TYPE="AS_BINARY">
LAAAAAIAAAADAAAA/////////////////////3AAAAB0AAAAEAYAAJ4DAAC2AQAAAAAAAAEAAAAB
AAAAAAAAAAAAAAAAAAAAAAAAAAAAAAAAAAAAAAAAAAAAAAAAAAAAAAAAAAAAAAAAAAAAAAAAAAAA
AAAAAAAAAAAAAAAAAAAAAAAAAAAAAAAAAAAAAAAAAAAAAAAAAAAAAAAAAAAAAAAAAAAAAAAAAAAA
AAAAAAAAAAAAAAAAAAAAAAAAAAAAAAAAAAAAAAAAAAAAAAAAAAAAAAAAAAAAAAAAAAAAAAAAAAAA
AAAAAAAAAAAAAAAAAAAAAAAAAAAAAAAAAkMAAAAAAAAAAAAAAAAAAAAAAAADAAAA1gEAAI0GAADd
AwAA230AAAMAAAAFAAAAAAgBAPQBAAAsAQAAAQAAAAEAAACFBAAAoQEAAAAAAAAAAAAAAAAAAAAA
AAAAAAAAAAAAAAAAAAAAAAAAAAAAAAAAAAAAAAAAAAAAAAAAAAAAAAAAAAAAAAAAAAAAAAAAAAAA
AAAAAAAAAAAA3n0AAAMDCAAFAAAAEQCMBPQBAAAsAQAAjAQAAAEAAACKBgAAoQEAAN99AAADAAgA
BQAAAAAEAQD0AQAALAEAAAEAAAABAAAAhQQAAKEBAAAAAAAAAAAAAAAAAAAAAAAAAAAAAAAAAAAA
AAAAAAAAAAAAAAAAAAAA4X0AAAMAAAAFAAAAAAwBAPQBAAAsAQAAAQAAAAEAAACFBAAAoQEAAOJ9
AAADAAAABQAAAAAQAQD0AQAALAEAAAEAAAABAAAAhQQAAKEBAADjfQAAAwAAAAUAAAAAFAEA9AEA
ACwBAAABAAAAAQAAAIUEAAChAQAAAAAAAAAAAAAAAAAAAAAAAAAAAAAAAAAAAAAAAAAAAAAAAAAA
AAAAAAAAAAAAAAAAAAAAAAAAAAAAAAAAAAAAAAAAAAAAAAAAAAAAAAAAAAAAAAAAAAAAAAAAAAAA
AAAAAAAAAAAAAAAAAAAAAAAAAAAAAAAAAAAA530AAAcAEAAFAAAAEASMBMYBAABlAQAAjAQAAAEA
AACKBgAAoQEAAAAAAAAAAAAAAAAAAAAAAAAAAAAAAAAAAAAAAAAAAAAAAAAAAAAAAAAAAAAAAAAA
AAAAAAAAAAAAAAAAAAAAAAAAAAAAAAAAAAAAAAAAAAAAAAAAAAAAAAAAAAAAAAAAAAAAAAAAAAAA
AAAAAAAAAAAAAAAAAAAAAAAAAAAAAAAAAAAAAAAAAAAAAAAAAAAAAAAAAAAAAAAAAAAAAAAAAAAA
AAAAAAAAAAAAAAAAAAAAAAAAAAAAAAAAAAAAAAAAAAAAAAAAAAAAAAAAAAAAAAAAAAAAAAAAAAAA
AAAAAAAAAAAAAAAAAAAAAAAAAAAAAO59AAADAAAABQAAAAEAAQCQAQAALAEAAAEAAAABAAAAhQQA
AKEBAAAAAAAAAAAAAAAAAAAAAAAAAAAAAAAAAAAAAAAAAAAAAAAAAAAAAAAAAAAAAAAAAAAAAAAA
AAAAAAAAAAAAAAAAAAAAAAAAAAAAAAAAAAAAAA==
</Pref>
<Pref ID="WindowLayoutVersion" TYPE="AS_INT">4</Pref>
<Pref ID="height" TYPE="AS_LONG">1050</Pref>
<Pref ID="width" TYPE="AS_LONG">1680</Pref>
</Preferences>
