<?xml version="1.0" encoding="UTF-8"?>
<Preferences>
	<Pref ID="WindowLayout" TYPE="AS_BINARY">
LAAAAAIAAAADAAAAAAAAAAAAAAD//////////1AAAABQAAAA8AUAAHoDAAC2AQAAAAAAAAEAAAAB
AAAAAAAAAAAAAAAAAAAAAAAAAAAAAAAAAAAAAAAAAAAAAAAAAAAAAAAAAAAAAAAAAAAAAAAAAAAA
AAAAAAAAAAAAAAAAAAAAAAAAAAAAAAAAAAAAAAAAAAAAAAAAAAAAAAAAAAAAAAAAAAAAAAAAAAAA
AAAAAAAAAAAAAAAAAAAAAAAAAAAAAAAAAAAAAAAAAAAAAAAAAAAAAAAAAAAAAAAAAAAAAAAAAAAA
AAAAAAAAAAAAAAAAAAAAAAAAAAAAAAAAAkMAAAAAAAAAAAAAAAAAAAAAAAADAAAA1gEAAI0GAADd
AwAA230AAAMAAAAFAAAAAAQBAPQBAAAsAQAAAQAAAAEAAADDAQAAoQEAAAAAAAAAAAAAAAAAAAAA
AAAAAAAAAAAAAAAAAAAAAAAAAAAAAAAAAADdfQAAA0MAAAUAAAAxAAwGfgAAAEABAAAMBgAAAQAA
AIoGAAC1AQAA3n0AAAMDCAAFAAAAIQDrA/QBAAAsAQAA6wMAAAEAAAAFBgAAtQEAAN99AAADAAgA
BQAAAAEAAQD0AQAALAEAAAEAAAABAAAAwwEAAKEBAAAAAAAAAAAAAAAAAAAAAAAAAAAAAAAAAAAA
AAAAAAAAAAAAAAAAAAAA4X0AAAMAAAAFAAAAAAgBAPQBAAAsAQAAAQAAAAEAAADDAQAAoQEAAOJ9
AAADAAAABQAAAAAMAQD0AQAALAEAAAEAAAABAAAAwwEAAKEBAADjfQAAAwAAAAUAAAAAEAEA9AEA
ACwBAAABAAAAAQAAAMMBAAChAQAAAAAAAAAAAAAAAAAAAAAAAAAAAAAAAAAAAAAAAAAAAAAAAAAA
AAAAAOV9AAADAAAABQAAABEAygFAAQAAQAEAAMoBAAABAAAA5AMAALUBAAAAAAAAAAAAAAAAAAAA
AAAAAAAAAAAAAAAAAAAAAAAAAAAAAAAAAAAAAAAAAAAAAAAAAAAAAAAAAAAAAAAAAAAAAAAAAAAA
AAAAAAAAAAAAAAAAAAAAAAAAAAAAAAAAAAAAAAAAAAAAAAAAAAAAAAAAAAAAAAAAAAAAAAAAAAAA
AAAAAAAAAAAAAAAAAAAAAAAAAAAAAAAAAAAAAAAAAAAAAAAAAAAAAAAAAAAAAAAAAAAAAAAAAAAA
AAAAAAAAAAAAAAAAAAAAAAAAAAAAAAAAAAAAAAAAAAAAAAAAAAAAAAAAAAAAAAAAAAAAAAAAAAAA
AAAAAAAAAAAAAAAAAAAAAAAAAAAAAAAAAAAAAAAAAAAAAAAAAAAAAAAAAAAAAAAAAAAAAAAAAAAA
AAAAAAAAAAAAAAAAAAAAAAAAAAAAAAAAAAAAAAAAAAAAAAAAAAAAAAAAAAAAAAAAAAAAAAAAAAAA
AAAAAAAAAAAAAAAAAAAAAAAAAAAAAAAAAAAAAAAAAAAAAAAAAAAAAAAAAAAAAAAAAAAAAAAAAAAA
AAAAAAAAAAAAAAAAAAAAAAAAAAAAAAAAAAAAAA==
</Pref><Pref ID="WindowLayoutVersion" TYPE="AS_INT">4</Pref><Pref ID="height" TYPE="AS_LONG">1050</Pref><Pref ID="width" TYPE="AS_LONG">1680</Pref>
</Preferences>
